10 10
##########
#        #
#    *   #
#  O     #
#        #
#      * #
#        #
# *      #
#        #
##########
