10 30
##############################
#           #        #   *   #
#    *                   *   #
#  O              #      *   #
#                            #
#      *       **            #
#          #                 #
# *       #        *         #
#        #         *         #
##############################