10 20
####################
#                  #
#    *             #
#  O               #
#             # #  #
#      *      # #  #
#                  #
# *        #       #
#                  #
####################